32 32
............#...#........#......
.................#...#...#......
...............#...........#....
.....#...........#......#.......
..................#...#.........
.....#.#........................
............@..#..........#.#...
.#....................#..#...#..
#.............#....#.....#..#...
......#....##................#..
............#....#..#.....#....#
....#....#.#............#.#.....
..............................#.
....#....#...............#..#...
#...........#...................
.#...........#.#......#.....#...
..#.........#........#.#.#......
...#..#.....#.....#....#........
............#...........#.......
.....#.............#.#..........
.#..#................#.#........
.............#................#.
............#.....#.#..........#
.......#.......#..#.......#....#
...#..##..............#.........
.....................#..........
...#....#.................#.#.#.
......#.........................
.........#.....##....#.....#.#..
....#....#.....#........#....#..
#...............................
#......................#........
